1111111111111111111111111111111
1000000100010000000C00000000C01
1000001000000011110000000000001
100000000C000001100C00100C00001
100P00000000C001110000000000001
100000000000000C0000E0001000011
1111111111111111111111111111111