1111111111111111111111111111111
1000000100010000000C00000000C01
1000001000000011110000000000001
100000000C000000C00100X00100001
100P00000000C001110000000000001
1000010000X0001C0000E0001000011
1111111111111111111111111111111