111111111111111111111111111111111111
1000000100010000000C00000000C0000001
100000100000001111000000X00000000001
100000000C000001100C00100C0000000001
100P00000000C00111000000000000000001
100000000000000C0000E000100000000011
111111111111111111111111111111111111